W W W G G G G G G G
W W G G G G G G G G
W G G 6 P P 7 G G G
G G G 5 4 G P G G G
G G G 2 3 G P G G G
G G G P G G P G G G
G G G P G G P G G G
G G G P G G 8 P 9 G
G G G P G G G G P G
G G G 1 G G G G 10 G