G G G G G G 5 G G G
G G G G G G P G G G
G G G G G G P G G G
G G G G G G P G G G
G G G G G G P G G G
G G G G G G P G G G
G G G 3 P P 4 G G G
G G G P G G G G G G
G G G 2 P P P P P 1
G G G G G G G G G G