G G G G G G G G G G
G G G G G G G G G G
W W G 3 P P 4 G G G
W W W P G G P W G G
1 P P 2 G G P W W G
W W W G G G P W G G
W W W W G G P G G G
G W W G G G 5 P P 6
G G G G G G G W W W
G G G G G G G G G G