G G 1 G G G G G G G
G G P G G G G G G G
G G P G G G G G G G
G G P G G G G G G G
G G 2 P P P 3 G G G
G G W W W G P G G G
G W W W W G 4 P P 5
G G W W W G G G G G
G G G W G G G G G G
G G G G G G G G G G