G 7 P P P P P P 8 G
G P W W W W W W P G
G P W W W W W W P G
G 6 P P P P 5 G P G
G G G G W W P G P G
G W W W W W P G 9 10
W W W 3 P P 4 G G G
G G W P G G G G G G
G G G 2 P P P P P 1
G G G G G G G G G G